12 15
###############
#P     #      #
# #### # #### #
#    # #    # #
# ## # #### # #
#  # #      # #
## # ######## #
#  #          #
# ########### #
#             #
#######    #E##
###############