20 20
####################
#P                 #
# ####### #######  #
# #     #       #  #
# # ##### ##### #  #
# # #         # #  #
# # ######### # ####
# # #       #      #
# ### ##### ###### #
#     #   # #      #
##### ### # # #### #
#   #     # #      #
# ### ##### # ######
#   #     #        #
# # ##### ###### ###
#   #         #  #E#
# ##### ####### ## #
#       #          #
####################
