8 10
##########
#P       #
# #### # #
#    # # #
# ## # # #
#    #   #
######  E#
##########