15 20
####################
#P         #       #
# ######## # ##### #
#        # #     # #
####### ## ##### # #
#     #          # #
# ### ############ #
# #              # #
# # ########### ## #
# #     #        # #
# ##### # ######## #
#       #          #
######### ######## #
#                E #
####################